1111111111
1000000001
1000200001
1000000001
1000000001
1000000001
1000000001
1000000031
1000000001
1111111111