1111111111
1100000001
1100210001
1010010101
1000010001
1001010001
1000010001
1001010031
1000000101
1111111111
